#####################
# I @@  .%    ##@#  #
# @#  %  @ # @@@@@ ##
# #  .     @ % #  . #
# .   % @       %   #
# #@  @ .    @@@@   #
# #     @#  @@@ .   #
# @    .% @  ## .   #
#####################