21 9
#####################
# I @@   .%   ##@#  #
# @#     @ # @@@@@ ##
# #        @ % #  . #
#.    % @       %   #
#  @  @ .    @@@@   #
# #     @#  @@@ .   #
# . @  .  @  ## .   #
#####################