27 11
###########################
# I @@  .%    ##     % @@ #
#  @#  %  @ #   ##  .. @% #
#  @ ##      %   @ . %@   #
# @  @ . @@     @ .  %   ##
#  % .   @   @# .    %  @ #
#    .%  @  ##  @@  . %@  #
#  %%      @@@ %    # %@  #
#  @@   #    . .  @ #   @ #
# . .  %@ % @@  % .  @ .  #
###########################