#######################
# I @@  .%    ##      #
#  @#  %  @ #   ##    #
#  @ ##      %        #
# @  @ . @@     @    ##
#     @#    .    %  @ #
#    .%  @  ##        #
#        @@@ %        #
#  @@   #    .  #   @ #
#       @@  % .  @ .  #
#######################