29 16
#############################
#@I@@@ # . @    ## @.    %% #
#    % .  @@@   #@    #  @@@#
#  @@   #      .   #   @@@@ #
#@   #  %@  @@#   %  @@     #
# @@ .%   @@   #. @% @@ .   #
# %#  #    @   #   .  . @   #
# @@@@@ % # @@@ . #   @@ .  #
#@ . # @@%  .  # @@  @@ .   #
#   %  . @@  # %  #@ @ %.   #
# @@   #.    @@ .   # .%@ . #
#@ @ . @@ . . # @ #   %     #
# @   #.   @   ##   @  @@   #
#    @@ #  # @ @@  . @@ #   #
#  @  # %%   @    .  #  %   #
#############################